NO ./assets/wall_no.xpm
SO ./assets/wall_so.xpm 
WE ./assets/wall_we.xpm
EA ./assets/wall_ea.xpm
F 18,70,33
C 77,150,255


   11111111111111111111111
   100N0000010010100001111
  11110001110111111111111
1000000000111111111111111
10000000000000111111
10000000000011111
1011111111111111111
101111111
1111111111111
1011111
1111111111111111111111111