.
.
.
.
.
.
.
.
1111111111111111111
100N00000000101
100000000000111111
1111111111111