NO ./assets/wall_no.xpm
SO ./assets/wall_so.xpm
WE ./assets/wall_we.xpm
EA ./assets/wall_ea.xpm
F 98,70,33
C 77,159,255


1111111111111111111
100N00000000101
100000000000111111
1111111111111